####8###6#######8
####8#7#7#######8
###78777777777777
####8#7#7#9#####8
####8777779777778
####8#7#7#9#####8
####8#77777777758
####8#7#7#9#####8
66668666789888888
####8#7#7#9#####8
####8#7#799999999
####8#7#7#9#####8
9999899#7#9#####8
####7###7#9#####8
8888888#7#9#####8
####7###7#6#####8
88888888777788888
