75955555556595557
7#9#8#5###6#9###7
7#9#8858886898887
7#9#5#5#9#6#9###7
7#9#7555555#98887
7#9#7#5#9#6#9#6#7
79997959996999697
7#9#7#5#9#6###6#7
7#9#7#5#9#6#5#6#7
##9#8#######5#6#7
##9#8#######5#6#7
##9#8#######5#6#7
##9#8#9#####5#6#7
##9#8#9#####5#6#7
55555557799959697
##9#8#9#####5#6#7
##9#8#9#####5#6#7
