9###8#9#8#####7#6
9###8#9#8#####7#6
97777777777776666
9###8#9#8###7#7#6
9###8555855575556
9###8###8###7#7#6
98888888888878886
9###8#7#8#8#7#6#6
8#888866668666666
8###8#7#8#8#7#6#6
55555555858#7#6##
8###8#7#8#8#9#6##
8###8#7#8#5#9#6##
8###8#7#8#8#9#6##
99998999898797677
8###8#7#8#9###6##
777777777777776##
