##7#8####96999899
##7#8#####6###8##
99798999956555855
##7#8#7###6###8##
88888888886999999
6#7#5#7###6###8##
677777777767678##
6#7#9#7###6#6#8##
6#7#9#7666666#8##
6#7#9#7###6#6#8##
66769677776767877
6#7#9#7###6#6#8##
88888878886868888
6#7#9#7###6#6####
99999995996969999
6###9#7###6#9####
6###887888689####
