77977####97999996
##9#7#####7#####6
##9#7#####7#####6
##9#7#####7#####6
##9#7#####7#####6
####7#####7#####6
66667666##7#####6
####7#####7#####6
####7#####7#####5
####7#####7#####6
99997999997999996
####7#####7#####6
666676666676666#6
####7#####7#####6
##667688887888885
####7#####7#####5
####7####77777775
