65555555755555555
6#5#5#8#7#8###6#5
6#5#5#8#7#8###6#5
6#6#5#8#7#8###6#5
6#675787778777885
6#6#5###7#8#5#6#5
99699999798999995
6#6#5###7#8#5#6#5
6#665666768555555
5#6#5#8#7#8#5#6#5
5#6#8888788#5#6#5
5#6#5#8#6#7#5#6#5
5#6#5#8#6#7#5#6##
5#5#5#8#6#7#5#6##
8868888888885#6##
5#6###8#6#7#5#6##
5#5#6887777777777
