9#577777775#####9
9#5#######8#####9
98588888888888888
9#5#######8###8#9
8#5555555585##8#9
8#5#######8#7#8#9
8#5######58575859
8#8#######8#7#8#9
8#8#####666676866
8#8#####9#8#7#8#7
85855555555555555
8#8#####9#8#7#8#7
558555555555798#7
8#8#####9#8#7###7
8#8###88888878888
8#8#####9#8#7###7
6686777777777###7
