77777788888897779
##7###8#####9###9
##7##585555595559
##7###8#####9###9
88888888888898888
##7###8#####9###8
##75778777##9#7#8
##7#6#8#####9#7#8
##7#6#8#####9#7#8
##7#6#8#####9#7#8
##7#6555555595755
##7#6#8#####9#7#8
55555555555555777
##7#6#########7#8
##7#6#######66666
##7#6#########7#8
##7#6#########7#8
